# # # # # # # # # # # # # # # # # # # # # # # # # # # # # # # # # # # # # # # # # # # # # # # # # # # # # # # # # # # # # 
# . # . . . # . . . . . . . . . # . # . . . . . # . . . . . . . # . . . # . . . . . . . # . # . # . . . # . . . . . . O # 
# . # # # . # # # # # . # # # . # . # . # . # # # # # . # # # # # . # . # . # # # . # # # . # . # # # . # # # # # # # . # 
# . # . . . # . # . # . # . . . . . # . # . # . . . . . . . # . # . # . . . . . # . # . # . # . . . . . # . . . . . # . # 
# . # # # . # . # . # # # # # # # . # . # # # # # # # # # . # . # . # . # # # # # # # . # . # # # . # . # . # # # # # . # 
# . . . . . . . # . . . # . # . # . . . . . # . . . . . # . . . . . # . . . # . # . . . . . . . # . # . # . . . # . . . # 
# # # . # # # # # # # . # . # . # # # # # . # # # # # . # # # . # # # # # . # . # # # # # # # . # . # # # . # # # . # # # 
# . # . . . . . # . . . # . . . # . . . . . # . . . # . # . . . . . # . # . . . . . # . . . # . . . # . . . . . . . . . # 
# . # . # # # # # . # # # # # . # # # . # . # # # . # . # # # . # # # . # # # # # # # # # . # . # . # . # # # . # . # # # 
# . . . . . # . . . # . # . . . . . . . # . # . . . # . # . . . . . . . # . # . . . . . . . . . # . . . . . # . # . # . # 
# # # # # . # . # . # . # . # # # # # . # . # . # . # . # # # . # # # . # . # . # . # # # # # # # # # . # # # # # # # . # 
# . . . . . . . # . . . . . . . # . . . # . # . # . # . . . # . # . . . # . . . # . # . # . . . . . # . # . # . . . . . # 
# # # . # . # . # # # . # . # # # # # . # . # . # . # . # # # . # # # # # # # . # # # . # . # # # # # . # . # . # # # . # 
# . . . # . # . . . # . # . . . . . # . # . # . # . # . . . . . # . # . . . . . . . # . # . # . # . # . . . # . # . . . # 
# . # # # # # . # . # # # . # # # . # # # # # # # . # . # . # # # . # . # # # . # . # . # . # . # . # . # . # . # # # # # 
# . # . # . . . # . . . # . . . # . # . # . . . # . . . # . . . . . # . # . . . # . # . . . # . . . # . # . # . # . . . # 
# # # . # # # # # . # # # # # # # . # . # # # . # # # . # # # . # # # # # # # . # . # . # # # . # # # # # . # . # . # . # 
# . # . . . . . # . # . # . . . . . # . . . . . . . # . . . # . . . # . . . . . # . . . . . . . . . # . . . . . # . # . # 
# . # . # # # . # # # . # # # . # . # # # # # . # # # # # # # . # # # . # # # # # # # . # # # . # # # # # # # . # . # # # 
# . # . # . . . . . # . . . # . # . . . . . . . # . # . . . . . # . # . # . . . . . # . # . # . . . # . . . . . . . . . # 
# . # . # # # . # . # . # # # . # . # # # # # . # . # . # . # # # . # # # # # . # # # . # . # # # . # . # # # . # # # . # 
# . # . # . . . # . # . . . . . # . # . # . # . . . . . # . # . . . . . . . # . . . . . . . # . . . # . # . # . # . . . # 
# . # . # # # . # # # # # # # # # . # . # . # . # # # # # # # # # . # # # # # # # . # # # . # # # . # . # . # # # # # . # 
# . . . . . # . . . . . . . # . . . . . # . . . . . # . . . . . . . # . # . . . # . # . . . # . # . # . # . # . . . # . # 
# . # # # # # . # . # # # # # . # # # # # . # # # # # # # # # . # . # . # # # . # # # # # . # . # . # . # . # # # . # . # 
# . # . # . . . # . # . . . . . # . # . . . # . # . . . . . # . # . . . # . . . . . # . # . # . . . # . . . . . . . # . # 
# . # . # # # # # . # # # # # . # . # # # # # . # # # . # . # . # # # . # # # # # . # . # # # # # # # . # # # . # # # . # 
# . . . . . . . # . . . . . . . . . . . . . . . . . # . # . # . # . . . # . # . . . # . . . . . # . . . # . . . # . # . # 
# . # # # . # # # # # # # # # # # . # . # # # # # # # . # # # . # # # . # . # # # . # . # # # # # # # . # # # # # . # . # 
# . . . # . # . # . . . . . # . . . # . # . . . # . . . # . . . . . # . . . # . . . . . . . # . . . . . . . . . # . . . # 
# . # . # # # . # # # . # . # # # . # # # . # # # . # # # # # # # # # . # . # . # . # # # . # # # # # . # # # . # . # . # 
# . # . . . . . # . . . # . . . # . . . . . . . . . . . . . . . # . . . # . # . # . . . # . . . . . # . . . # . # . # . # 
# . # . # # # # # # # . # . # # # . # # # . # # # # # . # # # . # . # . # # # # # . # # # . # # # . # . # # # . # . # # # 
# . # . . . . . . . # . # . . . # . # . . . # . . . . . # . # . # . # . # . . . . . . . # . . . # . # . # . . . # . # . # 
# # # . # # # # # . # . # . # # # # # # # # # # # . # . # . # # # . # # # . # # # . # # # . # # # . # # # . # . # # # . # 
# . . . . . # . # . . . # . . . # . # . . . # . . . # . . . . . . . . . . . . . # . . . # . . . # . . . . . # . # . # . # 
# . # # # . # . # # # # # . # # # . # . # # # . # # # # # # # . # # # . # # # # # . # # # # # . # # # . # . # . # . # . # 
# . . . # . . . # . # . # . # . . . . . . . # . # . # . # . . . # . # . # . . . # . . . . . # . # . . . # . # . # . # . # 
# # # # # # # . # . # . # . # # # # # . # # # # # . # . # . # # # . # . # # # . # # # . # # # # # . # # # # # . # . # . # 
# . . . . . . . . . . . # . . . . . . . . . # . # . . . # . # . . . . . # . # . . . . . # . . . # . . . # . . . . . # . # 
# . # # # # # . # . # . # # # # # # # . # . # . # . # # # # # . # # # # # . # # # # # . # . # . # . # # # # # . # . # . # 
# . . . # . . . # . # . # . . . # . # . # . # . . . . . # . . . # . . . . . . . . . # . . . # . # . # . . . . . # . . . # 
# # # # # # # # # . # # # # # . # . # . # # # # # . # . # # # # # . # # # . # . # # # # # . # # # . # . # . # . # # # # # 
# . . . # . # . # . . . . . # . # . # . # . . . . . # . . . . . . . # . . . # . . . # . . . . . # . # . # . # . # . . . # 
# . # # # . # . # # # . # # # . # . # # # # # . # . # . # # # . # . # . # . # # # # # . # . # # # # # # # . # # # # # . # 
# . . . . . . . . . # . . . . . . . . . . . . . # . # . . . # . # . # . # . . . . . # . # . . . . . # . # . # . # . . . # 
# # # . # . # # # . # . # # # . # # # # # # # # # # # # # . # # # . # . # # # # # . # . # # # # # . # . # . # . # . # # # 
# . . . # . # . # . . . . . # . # . . . . . . . # . # . # . . . # . # . # . # . . . # . # . . . . . # . . . # . # . . . # 
# . # # # # # . # . # . # # # # # . # . # # # . # . # . # . # # # # # # # . # . # # # # # # # . # # # . # . # . # # # . # 
# . # . . . . . . . # . . . . . . . # . # . . . . . . . # . . . # . . . . . . . # . . . . . . . . . # . # . . . . . . . # 
# # # # # # # # # # # # # # # # # # # # # # # # # # # # # # # # # # # # # # # # # # # # # # # # # # # # # # # # # # # # # 
