# # # # #
# . . . #
# . O . #
# . . . #
# # # # #