# # # # # # # # # # # # # # 
# O . . . . . . . . . . . #
# . . . . . . . . . . . . #
# . . . . . . . # . . . . #
# . . . . . . . # . . . . #
# . . . . . . . # . . . . #
# . . . . . . . # . . . . #
# . . . # # # # # . . . . #
# . . . . . . . . . . . . #
# . . . . . . . . . . . . #
# # # # # # # # # # # # # #