# # # # # # # # # # # # # # # # # # # # # # # # # # # # # # # # # # # # # # # # # # # # # # # # # # # # # # # # # # # # #
# O . . . . . . . . . . . . . . . . . . . . . . . . . . . . . . . . . . . . . . . . . . . . . . . . . . . . . . . . . . #
# . . . . . . . # # # . . . . . . . . . . . . . . . . . . . . . . . . . . . . . . . . . . . . . . . . . . . . . . . . . #
# . . . . . . # # . . . . . . . . . . . . . . . . . . . . . . . . . . . . . . . . . . . . . . . . . # # # # . . . . . . #
# . . . . . # # . . . . . . . . # . . . . . . . . . . . . . . . . . . . . . . . . . . . . # # # # # # # . . . . . . . . #
# . . . . # # . . . . . . . . . # . . . . . . . . . . . . . . . . . . . . . . . . . . . # # . # # . . . . . . . . . . . #
# . . . # # . . . . . . . . . . # # . . . . . . . . . . . . . # . . . . . . . . . . . # # . . . . . . . . . . . . . . . #
# . . # # . . . . . . . . . . . . # . . . . . . . . . . . . # . . . . . . . . . . . # # . . . . . . . . . . . . . . . . #
# . # # . . . . . . . . . . . . . # # . . . . . . . . . . . # . . . . . . . . . . # # . . . . . . . . . . . . . . . . . #
# . # . . . . . . . . . . . . . . . # # . . . . . . . . . . # . . . . . . . . . . # . . . . . . . . . . . . . . . . . . #
# . # . . . . . . . . . . . . . . . . # # . . . . . . . . . # . . . . . . . . . . # . . . . . . . . . . . . . . . . . . #
# . . . . . . . . . . . . . . . . . . . # # . . . . . . . . . # . . . . . . . . . # . . . . . . . . . . . . . . . . . . #
# . . . . . . . . . . . . . . . . . . . . # . . . . . . . . . # . . . . . . . . . # # . . . . . . . . . . . . . . . . . #
# . . . . . . . . . . . . . . . . . . . . # . . . . . . . . . # . . . . . . . . . . # . . . . . . . . . . . . . . . . . #
# . . . . . . . . . . . . . . . . . . . . # # . . . . . . . . # . . . . . . . . . . # # . . . . . . . . . . . . . . . . #
# . . . . . . . . . . . . . . . . . . . . . # . . . . . . . . # # . . . . . . . . . . . # . . . . . . . . . . . . . . . #
# . . . . . . . . . . . . . . . . . . . . . # # . . . . . . . . . . . . . . . . . . . . . # . . . . . . . . . . . . . . #
# . . . . . . . . . . . . . . . . . . . . . . # # . . . . . . . . . . . . . . . . . . . . # # # # . . . . . . . . . . . #
# . . . . . . . . . . . . . . . . . . . . . . . # # . . . . . . . . . . . . . . . . . . . . . . # # # # # # # . . . . . #
# . . . . . . . . . . . . . . . . . . . . . . . . # # . . . . . . . . . . . . . . . . . . . . . . . . . . . . . . . . . #
# . . . . . . . . . . . . . . . . . . . . . . . . . # # . . . . . . . . . . . . . . . . . . . . . . . . . . . . . . . . #
# . . . . . . . . . . . . . . . . . . . . . . . . . # # # # # . . . . . . . . . . . . . . . . . . . . . . . . . . . . . #
# # # # # # # # # # # # # # # # # # # # # # # # # # # # # # # # # # # # # # # # # # # # # # # # # # # # # # # # # # # # #