# # # # # # # # # # # # # # # # # # 
# . . . . . . . . . . . . . . . . # 
# . . . . . . . . . . . . . . . . # 
# . . . . O . . . . . . . . . . . # 
# . . . . . . . . . . . . . . . . # 
# . . . . . . . . . . . . . . . . # 
# . . . . # . # . # . # . . . . . # 
# # # # # # . # . # . # . . . . . # 
# . # . . . . . # # . # . . . . . # 
# . # . . . . . # # . # . . . . . # 
# . # . . . . . # # . # . . . . . #
# . . . . . . . . . . . . . . . . #
# # # # # # # # # # # # # # # # # # 