# # # # # # # # # # # # # # # # # # # # # # #
# O . . . . . . . . . . . . . . . . . . . . # 
# . . . . . . . . . . . . . . . . . . . . . #
# . . . . . . . . . . . . . . . . . . . . . #
# . . . # . # . # # # . # . . . # # # . . . #
# . . . # . # . # . # . # . . . # . # . . . #
# . . . # # # . # . # . # . . . # # # . . . #
# . . . # . # . # . # . # . . . # . # . . . #
# . . . # . # . # # # . # # # . # . # . . . #
# . . . . . . . . . . . . . . . . . . . . . #
# . . . . . . . . . . . . . . . . . . . . . #
# . . . . . . . . . . . . . . . . . . . . . #
# # # # # # # # # # # # # # # # # # # # # # #